000030087801900034000600005600000840350060092098000006200003000710004508480010000
000803000305470002801000003003009050000302000090500600100000506600035408000208000
000060100600009000032075080007002040500947008060300500080710250000500003009030000
204000007010002000600910400793000008020000060400000759002047001000600040800000205
040050000207040006930007500000405009500000002900302000009500028800060307000010060