050000739000570001000000060069002005100805004500300910090000000200038000718000040
008029000010080400039006000062000301070000050901000670000600230003070060000240700
000090000208005700503001000020008010900613007040200080000100506007900103000030000
140230000007005006003000050500740001000010000700028009030000700400100900000087042
094001300005300000201000070100820900000060000006075008020000804000004700009500120