407020010500600370060070000605041003003205100200380509000010090049002001070050402
030060008006010900408270060070002406000736000803400020010087602005040300700020010
100706008020010090050480007089000043070000010510000970200068030030070060900503002
003896000016200000250300070800015030100463005030780006070009058000008340000124900
290060000300000620657002380000089040042701590070250000083100962029000003000020075